EA ./textures/made_wall_e.xpm
NO ./textures/made_wall_n.xpm
SO ./textures/made_wall_s.xpm
WE ./textures/made_wall_w.xpm

F 0,   105,   148
C 255, 94, 77

111     1111111111111111111111111
101     100000000110000000000011
111     1011000001110000000000001
        1001000000000000000000001
111111111011000001110000000000001
100000000011000001110111111111111
111111111111111111111111111111111
11111111111111111111111111111
11110111111111011100000010001
11110111111111011101010000001
110000001101010111000000000011111
100000000000000011000000000000001
100000000000000011010100100011111
11000001110101011111011110N01
11110111 1110101 101111010001
11111111 1111111 111111111111