NO ./textures/colorstone.xpm
SO ./textures/eagle.xpm
WE ./textures/greystone.xpm
EA ./textures/bluestone.xpm

F 65,78,12
C 56,56,56

1111111111111111111111111111
101100000000110000000000011
1111011000001110000000000001
1001000000000000000000001
111111111011000001110000000000001
100000000011000001110111111111111
11110111111111011100000010001
11110111111111011101010000001
110000001101010111000000000011111
100000000000000011000000000000001
100000000000000011010100100011111
11000001110101011111011110N01
111101111110101101111010001
111111111111111111111111111
