NO ./textures/colorstone.xpm

SO ./textures/eagle.xpm

WE ./textures/greystone.xpm

EA ./textures/bluestone.xpm

F 65,255,0

C 56,56,0

1111111111111111111111111111
101100000000110000000000011
111101100000111000000000N001
1111111111111111111111111111