NO ./textures/colorstone.xpm
SO ./textures/eagle.xpm
WE ./textures/greystone.xpm
EA ./textures/bluestone.xpm

F 200,0,0
C 0, 0 ,0

1111111111111111111111111111
101100000000110000000000011
1111011000001110000000000001
100100000000000000000000111111111
111111111011000001110000000000001
100000000011000001110111111111111
11110111111111011100000010001
11110111111111011101010000001
110000001101010111000000000011111
100000000000000011000000000000001
100000000000000011010100100011111
11000001110101011111011110N001
1111011111101011011110100011
111111111111111111111111111
