NO ./textures/colorstone.xpm

F  65,          255,          0

SO ./textures/eagle.xpm
WE ./textures/greystone.xpm
EA ./textures/bluestone.xpm


C         0,			62,   255

1111111111111111111111111111
1011000000001100S00000000101
1111011000001110000000000001
1111110000000000000001111111
1111111111111111111001111111
1111000000001100000000000101
1111011000001110000000000001
1111111111111111111111111111