NO ./textures/colorstone.
SO ./textures/eagle.xpm
WE ./textures/greystone.xpm
EA ./textures/bluestone.xpm

F 65,78,12
C 56,56,56

1111111111111111111111111111
101100000000110000000000011
1111011000001110000000000001
1001000000000000000000001111111111
111111111011000001110000000000001
100000000011000001110111111111111
1111111111111110011111
111111111111111001111111111111
111101111111110001100000010001
111101111111110111010100000011
110000001101010111000000000011111
100000000000000011000000000000001
100000000000000011010100100N11111
11000001110101011111011110001
1111011111101011011110100011
111111111111111111111111111
1111111111111111111111111
1111111111111111111111111
1111111111111111111111111
1111111111111111111111111
1111111111111111111111111
1111111111111111111111111
1111111111111111111111111
1111111111111111111111111